%% %%%%%%%%%%
%% %%%%%K%%%%
%% %%%%% %%%%
%          %%
%    O      %
%    %%%%%%%%
%    %%%%%%E%
%    %%%%%% %
%           %
%%%%%%%%%%%%%
