######
# ####
#   ##
## # #
##   #
######
