%%%%%%%%%%
% %%% %% %
%   %    %
%%%   %% %
%%%%  %% %
%%%%  %% %
%%%  %%  %
%    %%%%%
% %%     %
% %%%%%%%%
%  %%%%%%%
%%%%%%%%%%
